ҮЂӃҴҸһЂЂЂӃҴҴӄ隀ҿ隀隀隀隀隀隀隀隀隀隀
ЂЂҳҵЂҳӄЂЂҳҺҺҺҴҵ隀隀隀隀隀隀隀隀隀隀
ЂӃҺҵЂӂҺҴҴҺҺҺҺҺҵ隀隀隀隀隀隀隀隀隀隀
ЂӂҺҵЂЂҳҺҺҺҺҺҺҺҺӀ隀隀隀隀隀隀隀隀隀
ҿЂҳҺҴҴҶҺҺҺҺҺҺҺҵ隀隀隀隀隀隀隀隀隀隀
ҳҴҶҶҶӅЂҳҺҺҺҺҺҺҵ隀隀隀隀隀隀隀隀隀隀
ӂӅЂЂЂЂӃҺҺҺҺҺҺҺҵЂ隀隀隀隀隀隀隀隀隀
ЂЂЂЂЂЂҳҶҺҶҺҺҺҺҵЂ隀隀隀隀隀隀隀隀隀
ЂЂЂЂЂӃҵЂҷЂҳҺҺҺӅЂ隀隀隀隀隀隀隀隀隀
ҾҸҴҴҴҺҺҴҺҴҺҺҺӅЂ隀隀隀隀隀隀隀隀隀隀
ҷЂҳҺҺҺҺҶҶҺҺҺӅ隀隀隀隀隀隀隀隀隀隀隀隀
ҳҴҺҺҺҺҵЂЂҳҺӅЂ隀隀隀隀隀隀隀隀隀隀隀隀
ҳҺҺҺҺҺҺҴҴҺӅҿЂЂ隀隀隀隀隀隀隀隀隀隀隀
ҳҺҺҺҺҺҺҺҺӅӃЂ隀Ђ隀隀隀隀隀隀隀隀隀隀隀
ҳҺҺҺҺҺҺҺҵӃӃҿ隀Ђ隀隀隀隀隀隀隀隀隀隀隀
ҳҺҺҺҺҺҺҺӅЂӃЂЂҮ隀隀隀隀隀隀隀隀隀隀隀
ҳҺҺҺҺҺҺҵҹҹЂЂЂЂ隀隀隀隀隀隀隀隀隀隀隀
ҳҺҺҺҺҺҺҺЂЂЂЂ隀Ү隀隀隀隀隀隀隀隀隀隀隀
ҳҺҺҺҺҺҺҵЂЂЂ隀隀隀隀隀隀隀隀隀隀隀隀隀隀
ӂҶҶҶҶҶҶӅЂЂҹҹҮ隀隀隀隀隀隀隀隀隀隀隀隀
