ϻϻϻϻϻϻϻϻҿ隀ҿ隀ӃҴҴҴҴҴҴҴҴҴҴҴӄ
ϻϻϻϻϻϻϻϻҽҴҶҸҶҺҺҺҺҺҺҺҺҺҺҺҵ
ϻϻϻϻϻϻϻϻϻҷ隀隀隀ҳҺҺҺҺҺҺҺҺҺҺҵ
ϻϻϻϻϻϻϻϻϻӁ隀隀ӃҺҺҺҺҺҺҺҺҺҺҺҵ
ϻϻϻϻϻϻϻϻ隀隀隀隀ӂҶҶҺҺҺҺҺҺҺҺҺҵ
ϻϻϻϻϻϻϻϻ隀隀隀隀隀隀隀ҳҺҺҺҺҺҺҺҺҵ
ϻϻϻϻϻϻϻҮ隀隀隀Ӄӄ隀ӃҺҺҺҺҺҺҺҺҺҵ
ϻϻϻϻϻ隀Ү隀隀隀ӃҺҺҴҺҺҺҺҺҺҺҺҺҺҵ
ϻϻϻҿ隀Ү隀隀ҹҸҺҶҶҺҺҺҺҺҺҺҺҺҺҺҵ
ϻϻ隀Ӂ隀隀隀ҿ隀隀Ӂ隀隀ҳҺҺҺҺҺҺҺҺҺҺҵ
隀隀隀隀ҹҸҴҶһ隀隀ӃҴҺҺҺҺҺҺҺҺҺҺҺҵ
隀隀隀隀隀隀Ӂ隀ҳӀ隀ҳҺҺҺҺҺҺҺҺҺҺҺҺҵ
隀隀隀隀隀隀隀ҹҼ隀ӃҺҺҺҺҺҺҺҺҺҺҺҺҺҵ
隀隀隀隀隀隀隀隀隀ҾҶҺҺҺҺҺҺҺҺҺҺҺҺҺҵ
隀隀隀隀隀隀隀隀隀ҷ隀ҳҺҺҺҺҺҺҺҺҺҺҺҺҵ
隀隀隀隀隀隀隀ҹҴҺҴҺҺҺҺҺҺҺҺҺҺҺҺҺҵ
隀隀隀隀隀隀隀隀ҳҺҺҺҺҺҺҺҺҺҺҺҺҺҺҺҵ
隀隀隀隀隀隀隀隀ҳҺҺҺҺҺҺҺҺҺҺҺҺҺҺҺҵ
隀隀隀隀隀隀隀隀ӂҺҺҺҺҺҺҺҺҺҺҺҺҺҺҺҵ
隀隀隀隀隀隀隀隀隀ӂҶҶҶҶҶҶҶҶҶҶҶҶҶҶӅ
