隀隀隀隀隀隀隀隀隀隀隀隀隀隀隀隀隀隀隀隀隀隀隀隀隀
隀隀隀隀隀隀隀隀隀隀隀隀隀隀隀隀隀隀隀隀隀隀隀隀隀
隀隀隀隀隀隀隀隀隀隀隀隀隀隀隀隀隀隀隀隀隀隀隀隀隀
隀隀隀隀隀隀隀隀隀隀隀隀隀隀隀隀隀隀隀隀隀隀隀隀隀
隀隀隀隀隀隀隀隀隀隀隀ѶѰѰѰѰѰѳ隀隀隀隀隀隀隀
隀隀隀隀隀隀隀隀ѶѰѰѴӃҴҴҴӄѵѰѳ隀隀隀隀隀
隀隀隀隀隀隀隀隀ѯӃҴҴҺҺҺҺҺҴӄѵѳ隀隀隀隀
隀隀隀隀隀隀隀ѶѴҳҺҺҺҺҺҺҺҺҺӄѯ隀隀隀隀
隀隀隀隀隀隀ѶѴӃҺҺҺҺҺҺҺҺҺҺҵѯ隀隀隀隀
隀隀隀隀隀ѶѴӃҺҺҺҺҺҺҺҺҺҺҺӅѯ隀隀隀隀
隀隀隀隀隀ѯӃҺҺҺҺҺҺҺҺҺҺҺҵѻѭ隀隀隀隀
隀隀隀隀隀ѯӂҺҺҺҺҺҺҺҺҺҺҺӅѫѽ隀隀隀隀
隀隀隀隀隀ѵѳӂҺҺҺҺҺҺҺҺҺӅѶѴ隀隀隀隀隀
隀隀隀隀隀隀ѵѸҳҺҺҺҺҺҶҶӅѶѴ隀隀隀隀隀隀
隀隀隀隀隀隀隀隀ӂҶҶҶҶӅѶѰѰѴ隀隀隀隀隀隀隀
隀隀隀隀隀隀ѱѰѰѰѰѰѰѰѴ隀隀隀隀隀隀隀隀隀隀
隀隀隀隀隀隀隀隀隀隀隀隀隀隀隀隀隀隀隀隀隀隀隀隀隀
隀隀隀隀隀隀隀隀隀隀隀隀隀隀隀隀隀隀隀隀隀隀隀隀隀
隀隀隀隀隀隀隀隀隀隀隀隀隀隀隀隀隀隀隀隀隀隀隀隀隀
隀隀隀隀隀隀隀隀隀隀隀隀隀隀隀隀隀隀隀隀隀隀隀隀隀
