隀隀隀隀隀隀隀ълы隀隀隀隀隀隀隀隀隀隀隀隀隀隀隀
隀隀隀隀隀隀隀щннпппппппллы隀隀隀隀隀
隀隀隀隀隀隀隀隀隀隀隀隀隀隀隀隀隀ксм隀隀隀隀隀
隀隀ълы隀隀隀隀隀隀隀隀隀隀隀隀ксм隀隀隀隀隀
隀隀ксм隀隀隀隀隀隀隀隀隀隀隀隀ксм隀隀隀隀隀
隀隀ксм隀隀隀隀隀хппппппннь隀隀隀隀隀
隀隀ксм隀隀隀隀隀о隀隀隀隀隀隀隀隀隀隀隀隀隀隀
隀隀кнь隀隀隀ълсы隀隀隀隀隀隀隀隀隀隀隀隀隀
隀隀о隀隀隀隀隀кссм隀隀隀隀隀隀隀隀隀隀隀隀隀
隀隀о隀隀隀隀隀кссм隀隀隀隀隀隀隀隀隀隀隀隀隀
隀隀о隀隀隀隀隀кссспппппппппт隀隀隀
隀隀фпппппсссм隀隀隀隀隀隀隀隀隀о隀隀隀
隀隀隀隀隀隀隀隀кссм隀隀隀隀隀隀隀隀ъсы隀隀
隀隀隀隀隀隀隀隀щннь隀隀隀隀隀隀隀隀ксм隀隀
隀隀隀隀隀隀隀隀隀隀隀隀隀隀隀隀隀隀隀隀ксм隀隀
隀隀隀隀隀隀隀隀隀隀隀隀隀隀隀隀隀隀隀隀кнь隀隀
隀隀隀隀隀隀隀隀隀隀隀隀隀隀隀隀隀隀隀隀о隀隀隀隀
隀隀隀隀隀ълллпппппппппппу隀隀隀隀
隀隀隀隀隀кссм隀隀隀隀隀隀隀隀隀隀隀隀隀隀隀隀
隀隀隀隀隀щннь隀隀隀隀隀隀隀隀隀隀隀隀隀隀隀隀
