隀隀隀隀隀隀隀隀隀隀隀隀隀隀隀隀隀隀隀隀隀隀隀隀隀
隀隀隀隀隀隀隀隀隀隀隀隀隀隀隀隀隀隀隀隀隀隀隀隀隀
隀隀隀隀隀隀隀隀隀隀隀隀隀隀隀隀隀隀Ѐ隀隀隀隀隀隀
隀隀隀隀隀隀隀隀隀隀隀隀隀隀隀隀隀隀隀隀隀隀隀隀隀
隀隀隀隀隀隀隀隀ј隀隀隀隀隀隀隀隀隀隀隀隀隀隀隀隀
隀隀隀隀隀隀隀ќѓэээээээѝ隀隀隀隀隀隀隀隀
隀隀隀隀隀隀隀ьѓѓѓѓѓѓѓѓю隀隀隀隀隀隀隀隀
隀隀隀隀隀隀隀ьѓѓѓѓѓѓѓѓю隀隀隀隀隀隀隀隀
隀隀隀隀隀隀隀ьѓѓѓѓѓѓѓѓю隀隀隀隀隀隀隀隀
隀隀隀隀隀隀隀ћѓѓѓѓѓѓѓѓю隀隀隀Ѐ隀隀隀隀
隀隀隀隀隀隀隀隀ьѓѓѓѓѓѓѓю隀隀隀隀隀隀隀隀
隀隀隀隀隀隀隀隀ьѓѓѓѓѓѓѓю隀隀隀隀隀隀隀隀
隀隀隀隀隀隀隀隀ьѓѓѓѓѓѓѓю隀隀隀隀隀隀隀隀
隀隀隀隀隀隀隀隀ьѓѓяяяяяў隀隀隀隀隀隀隀隀
隀隀隀隀隀隀隀隀ћяў隀隀隀隀隀隀隀隀隀隀隀隀隀隀
隀隀隀隀隀隀隀隀隀隀隀隀隀隀隀隀隀隀隀隀隀隀隀隀隀
隀隀隀隀隀隀隀隀隀隀隀隀隀隀隀隀隀隀隀隀隀隀隀隀隀
隀隀隀隀隀隀隀隀隀隀隀隀隀隀隀隀隀隀隀隀隀隀隀隀隀
隀隀隀隀隀隀隀隀隀隀隀隀隀隀隀隀隀隀隀隀隀隀隀隀隀
隀隀隀隀隀隀隀隀隀隀隀隀隀隀隀隀隀隀隀隀隀隀隀隀隀
