隀隀隀隀ЀЀ隀隀隀隀隀隀隀隀隀隀隀隀ЀЀ隀隀隀隀隀
隀隀隀ЀЀ隀隀隀隀隀隀隀隀隀隀隀隀隀隀Ѐ隀隀隀隀隀
隀隀ЀЀ隀隀隀隀隀隀隀隀隀隀隀隀隀隀ЀЀЀ隀隀隀隀
隀隀Ѐ隀隀隀隀隀隀隀隀隀隀隀隀隀隀隀隀隀Ѐ隀隀隀隀
隀隀Ѐ隀隀隀҈Ҋϳ҃҂҂҂҂҂҂҂҅隀隀ЀЀ隀隀隀
隀隀Ѐ隀隀隀ҁ隀隀隀隀隀ϮϽϽ隀䉁ҁ隀隀隀Ѐ隀隀隀
隀ЀЀ隀隀隀ҁ隀隀隀隀隀隀隀隀隀Ϭҁ隀隀隀Ѐ隀隀隀
隀ЀЀ隀隀隀ҁ隀隀隀隀隀隀隀隀隀隀ҁ隀隀隀Ѐ隀隀隀
隀Ѐ隀隀隀隀ҁ隀隀隀隀隀隀隀隀隀隀ҁ隀隀隀Ѐ隀隀隀
隀Ѐ隀隀隀隀ҁ隀隀隀隀隀隀隀隀隀隀ҁ隀隀ЀЀ隀隀隀
隀Ѐ隀隀隀隀҇҅隀隀隀隀隀隀隀隀隀ҁ隀隀隀ЀЀ隀隀
隀ЀЀ隀隀隀隀ҁ隀隀隀隀隀隀隀隀隀ҁ隀隀隀ЀЀ隀隀
隀隀Ѐ隀隀隀隀ҁ隀隀隀隀隀隀隀隀隀ҁ隀隀隀Ѐ隀隀隀
隀隀Ѐ隀隀隀隀ҁ隀隀隀隀ϾϾϾϿ隀ҋ隀隀隀Ѐ隀隀隀
隀隀ЀЀ隀隀隀ҁ隀隀隀҃҂҂҂҂Ҋ隀隀隀隀ЀЀ隀隀
隀隀隀Ѐ隀隀隀҇҂҂Ҋ隀隀隀隀隀隀隀隀隀隀ЀЀ隀隀
隀隀隀ЀЀ隀隀隀隀隀隀隀隀隀隀隀隀隀隀隀隀Ѐ隀隀隀
隀隀隀隀隀隀隀隀隀隀隀隀隀隀隀隀隀隀隀隀ЀЀ隀隀隀
隀隀隀隀隀隀隀隀隀隀隀隀隀隀隀隀隀隀隀ЀЀ隀隀隀隀
隀隀隀隀隀隀隀隀隀隀隀隀隀隀隀隀隀隀隀隀隀隀隀隀隀
