隀隀隀隀隀隀隀隀隀隀隀隀隀隀隀隀隀隀隀隀隀隀隀隀隀
隀隀隀隀隀隀隀隀隀隀隀隀隀隀隀隀隀隀隀隀隀隀隀隀隀
隀隀隀隀隀隀隀隀隀隀隀隀隀隀隀隀隀隀隀隀隀隀隀隀隀
隀隀隀隀隀隀隀隀隀隀隀隀隀隀隀隀隀隀隀隀隀隀隀隀隀
隀隀隀隀隀隀隀隀隀隀隀隀隀隀隀隀隀隀隀隀隀隀隀隀隀
隀隀隀隀隀隀隀隀隀隀隀隀隀隀隀隀隀隀隀隀隀隀隀隀隀
隀隀隀隀隀隀隀ϯϯϯ隀ϯϯ隀ϯ隀隀隀隀隀隀隀隀隀隀
隀隀隀隀隀隀ϯϯϯϯϯ隀ϯ隀ϯϯϯϯϯ隀隀隀隀隀隀
隀隀隀隀隀隀隀ϯ隀ϯ隀ϯ隀ϯ隀ϯ隀ϯϯ隀隀隀隀隀隀
隀隀隀隀隀隀隀ϯϯϯϯϯϯϯ隀ϯϯϯϯ隀隀隀隀隀隀
隀隀隀隀隀隀ϯϯϯϯϯ隀ϯ隀ϯϯϯϯ隀隀隀隀隀隀隀
隀隀隀隀隀隀隀隀ϯ隀ϯϯϯϯϯϯ隀隀隀隀隀隀隀隀隀
隀隀隀隀隀隀隀隀隀隀隀隀隀隀隀隀隀隀隀隀隀隀隀隀隀
隀隀隀隀隀隀隀隀隀隀隀隀隀隀隀隀隀隀隀隀隀隀隀隀隀
隀隀隀隀隀隀隀隀隀隀隀隀隀隀隀隀隀隀隀隀隀隀隀隀隀
隀隀隀隀隀隀隀隀隀隀隀隀隀隀隀隀隀隀隀隀隀隀隀隀隀
隀隀隀隀隀隀隀隀隀隀隀隀隀隀隀隀隀隀隀隀隀隀隀隀隀
隀隀隀隀隀隀隀隀隀隀隀隀隀隀隀隀隀隀隀隀隀隀隀隀隀
隀隀隀隀隀隀隀隀隀隀隀隀隀隀隀隀隀隀隀隀隀隀隀隀隀
隀隀隀隀隀隀隀隀隀隀隀隀隀隀隀隀隀隀隀隀隀隀隀隀隀
